########
#     #
##  #  #
#  # * #
#    #*#
#   #  #
#      #
########