########
#      #
#      #
#      #
#  *   #
#      #
#******#
########