####### #
#       #
#       #
#       #
#  *    #
#       #
#****** #
####### #