######_##
#**___*_#
_x_#__###
_#____#_#
######x_#