######  # #
#         #
#         #
#         #
#  *      #
#         #
#******   #
#######   #