########
#      #
#      #
#     # 
#      #
#      #
#      #
########