########
#      #
#      #
#     # 
#  *   #
#      #
# *    #
########