###########
#*****# * #
#     #   #
#   * #   #
#         #
#    *    #
#         #
###########
