##_#####
#______#
#x#__#_#
___#_*__
#____#__
#*_#*__#
##_#####